0000000000000000000
0000111110111110000
0001111100011111000
0011111000001111100
0111110000000111110
0000000000000000000
0111110000000111110
0011111000001111100
0001111100011111000
0000111110111110000
0000000000000000000
