1000101110111101001
1000101000100101001
1101101110111000110
0101001000100100110
0010001110100100110
0000000000000000000
0111001100011001110
1000010010100101001
1011010010100101001
1001010010100101001
1111001100011001110
