0100001110111000010
0110001110111000110
0011000111110001100
0001100011100011000
1000110001000110001
1100011000001100011
1000110001000110001
0001100011100011000
0011000111110001100
0110001110111000110
0100001110111000010
