0011111110111111100
0111111100011111110
1111111000001111111
1111110000000111111
1111100000000011111
0000000000000000000
1111100000000011111
1111110000000111111
1111111000001111111
0111111100011111110
0011111110111111100
