00101110111010101110
00100010001010101000
00101110111011101110
00101000001000100010
00101110111000101110
00000000000000000000
11101110111011101110
10001010101010101010
11100010111011101010
10100010101000101010
11100010111011101110
