1111111111111111111
1000000000000000001
1011111111111111101
1010000000000000101
1010111111111110101
1010100000000010101
1010111111111110101
1010000000000000101
1011111111111111101
1000000000000000001
1111111111111111111
