1111111111111111111
1000000000000000001
1011111111111111101
1010000000000000101
1010111111111100101
1010100000000000101
1010111111111111101
1010000000000000001
1011111111111111111
1000000000000000000
1111111111111111111
