1010101010101010101
0101010101010101010
1010101010101010101
0101010101010101010
1010101010101010101
0101010100010101010
1010101010101010101
0101010101010101010
1010101010101010101
0101010101010101010
1010101010101010101
