0000000000000000000
0111111111111111110
0111111111111111110
0111111111111111110
0111111111111111110
0111111110111111110
0111111111111111110
0111111111111111110
0111111111111111110
0111111111111111110
0000000000000000000
